16,8,,,,,,,,,,,,,,,,
1,1,1,1,1,1,1,2,1,1,1,1,1,1,1,1,1,0
3,0,0,0,0,0,0,0,2,1,1,1,1,1,3,3,3,0
3,0,0,0,0,0,0,0,0,2,1,1,1,1,3,3,3,0
3,0,0,0,0,0,0,0,0,0,2,1,1,1,3,3,3,0
3,0,0,0,0,0,0,0,0,0,0,2,1,1,3,3,3,0
3,0,0,0,0,0,0,0,0,0,0,0,0,0,3,3,3,0
3,0,0,0,0,0,0,0,0,0,0,0,0,0,3,3,3,0
3,0,0,0,0,0,0,0,0,0,0,0,0,0,3,3,3,0
